ar	r	er	R
ovinoy	binoy	obinoy	obhinoy
kore	kora	kra	kre	kare
khelben	kelben	kalben	kelban khelban
khelle	kelle	khella	kella	khealla
harami	harmi hrmi	hami	harm	hami
celebrity	selibrity	celibrety chelebrati
juta	juto zuto	
dhur	dur	dor
bekub	bakub	bukub	bokob
bandirpo	badirpo	bapo	bendirpo	badipo	bendipo
ghumay	gumay	gomay	gumai	ghumai
thak	tak	thk
abasik	avashik abhashik asabik
khanki	kanki	khenki
magi	megi	maigi
bokachoda	bkachoda	bkchoda	bakchoda
pagol	hagol	pagli	pegli	pgli	pegl	pagl	pagla
chagol	cagol	sagol	chagl	sagl	chagi	sagi
banchod	benchod	bancod	bansod	bencod
faltu	fltu	fatu	failtu
shala	chala	ala	sala
shali	sali	chali	cali
mara	mera	mara	
shorir	chorir	sorir	shurir
khaia	khaia khaya	khaya
uthe	ote ute ate
chudte	chodte	cchode	chhudte choodte chowdte
janwar	janoar	januar	janaur	jannar
banor	banwor	banur	bainur
noshto	nosto nasto nusto nwosto
mal	mel	maal	malll
dudh	dodh	dud	dudu	dodo	dudo
hoga	huga	haga	houga	hwga
bustard	bastard	bstarat	vastard
banichodgiri	bainchodgari	baichodgari	baigari	bancodgiri
shodorghat	sodorghat	shodorgut	chodorghat
bejonma		bajonma	bejamana	benjonma
chechin	chchin chaichin	sechin
abal	aballl	albal	abballl
tui	2i	toi	tuui
magi	megi	maigi	megi	maig
shomoy	somoy	ammoy	samoy
karone	karona	krne kaone
kharap	kharep	kharap
vasay	bhasay	basay	vhasay	basai
pagol	pagoler	pagler	pglar	paglar
jokhon	jakhan	jkhon	jekhn
rail	rely	raile
station	stion	stition
geyechilo	gacileo
valo	volo	voloi	vlo	valu	valop
sundor	sondor sndor	sndr
hasi	hese
noforman	naforman	nafrman	naformen
bal	baler	balder
dhongsho	dhongshor	dhongso
jahannam	jahannamer	jannamer
celebrity	chilibrity	selibrity
koshto	ksto	kosto	kshto
inshallah	inshaaallah	insallah
salarputh	salarpoth
fatafati	phataphati
pagole	pagol	pagoler
chagol	chagoler	cagol	sagl
nosto	noshto	nshto	nsto




